aan de linkerkant	on the left side
aandoen	to put clothes around the body (sweater, suit)
aanhebben	to have smth on you
aanvragen	to apply for
aanwezig	present (adj.)
actief	active
afgelopen	last (2)
afkoelen	to cool
afrekenen	to pay (2)
algemeen	general
allebei	both (2)
beantwoorden	to answer (to smth., e.g. jouw vraag)
bedankt	thanks
bekijken	to look at
beloven	to promise
beneden	down, downstairs
bereiken	to reach
beschikbaar	available
besluiten	to decide (2)
best klein	quite small
bestaan	to exist
betekenen	to mean (2)
betreffen	to concern
bevriend zijn	to be friends
binnen	within
boos	angry
chagrijnig	grumpy (1)
daardoor	thereby, thus
daarom	therefore
daarover	about it
daarvan	thereof, from that
daarvoor	before that (adv.)
de aandacht	the attention
de advocaat	the lawyer
de afstand	the distance
de agenda	the diary
de allochtoon	the immigrant
de arm	the arm
de baan	the job
de baard	the beard
de bedoeling	the intention
de behoefte	the need
de benzine	the petrol
de bewoner	the occupant
de bezem	the broom
de bijbaan	the job on the side
de bliksem	the lightning
de boekhouder	the accountant
de boodschap	the purchase, shopping
de boodschappen	the groceries
de boom	the tree
de borg	the deposit
de borst	the chest
de buren	the neighbours
de caissière	the cashier
de champignon	the champignon
de colbert	the suit jacket
de collega	the colleague
de cursus	the course
de diepvriezer	the freezer
de dierenartsenpraktijk	the veterinary clinic
de dierentuin	the zoo
de dolfijn	the dolphin
de donder	the thunder
de drank	the drink
de duif	the pigeon
de echtgenote	the wife
de eekhoorn	the squirrel
de eerste hulp	the first aid
de eettafel	the dining table
de eeuw	the century
de erwt	the pea
de ezel	the donkey
de familie	the family
de fauteuil	the armchair
de feestdagenkalender	the holiday calendar
de fietsenwinkel	the bicycle shop
de friet	the French fries
de functie	the job position
de geit	the goat
de graanproducten	the cereals
de gracht	the canal (urban)
de grap	the joke
de grens	the border
de haai	the shark
de haas	the hare
de hamster	the hamster
de handschoen	the glove
de hei	the moor
de herenfiets	the men's bicycle
de hoer	the prostitute
de huurwoning	the rental house
de invloed	the influence
de keukenkast	the kitchen cupboard
de kledingkast	the wardrobe
de kleren	the clothes
de koe	the cow
de koffie	the coffee
de kok	the cook
de kookles	the cooking class
de kool	the cabbage
de kruiden	the spices
de last	the load
de leraar	the teacher (in a school)
de letter	the letter (2)
de makelaar	the real estate agent
de manier	the way
de melkchocolade	the milk chocolate
de mening	the opinion
de meubels	the furniture
de mevrouw	the Ms./Mrs.
de moeite	the difficulty
de muis	the mouse
de nachtlamp	the nightlight
de naturalisatie	the naturalisation
de neef	the nephew, male cousin
de ober	the waiter
de omgeving	the environment, surroundings
de ontsteking	the inflammation
de orde	the order (2)
de oven	the oven
de overeenkomst	the similarity
de peer	the pear
de persoon	the person
de plaats	the place (general, broad area)
de pont	the ferry
de praktijk	the practice
de premier	the prime minister
de pruim	the plum
de rand	the edge
de reep	the bar
de reiskosten	the travel expenses
de remmen	the brakes
de rest	the rest
de ring	the ring, the ring road
de rondvaart	the cruise
de rook	the smoke
de ruzie	the quarrel
de salontafel	the coffee table
de schaar	the scissors
de schildpad	the turtle
de schoonmoeder	the mother-in-law
de smaak	the taste
de sportschool	the gym
de stamboom	the family tree
de stand	the a) position b) score
de steen	the stone
de stof	the material
de storm	the storm
de streek	the region
de suiker	the sugar
de toestand	the state (2)
de trap	the stairs
de tuinstoel	the lawn chair
de uitleg	the explanation (2)
de vakantie	the holiday
de veiligheid	the safety
de verblijfsvergunning	the residence permit
de verdeling	the layout
de vereniging	the assotiation, union
de vergiftiging	the poisoning
de verklaring	the explanation (1)
de vrachtwagenchauffeur	the truck driver
de vrijetijdsbesteding	the leisure activity
de waarde	the value
de wallen	the fortified walls
de wijze	the manner, way of doing smth
de woonplaats	the place of residence
de yoghurt	the yogurt
de zak	the bag (big)
de ziektekostenverzekering	the health insurance
de zonnebril	the sunglasses
de zoon	the son
de zorg	the a) care b) worry
dergelijk	such (adj.)
doordat	because (3)
draaien	to turn
dronken zijn	being drunk
druk	busy, crowded
drukken	to print
drukte	bustle
duidelijk	clear
dus	so (than)
één	one
een vraag stellen	to ask a question
eigenwijs	stubborn, self-assured
elektrisch	electric
enige	(my/the) only (+smth)
enkele	few, some
ervan	of it
ervoor	ensure
exclusief	excluding
Frans	French
gebeuren	to happen
gebruikelijk	common
gedragen	to behave
gedurende	during (1)
gelden	to apply
gelijk	equal
gemeubileerd	furnished
gescheiden	divorced
getrouwd	married
gewoon	just (as usual), simply, ordinary
goed	well
goh	oh
gooien	to throw
groeien	to grow
haast hebben	to be in a hurry
hard	hard
hen	them
herkennen	to recognize
het adres	the address
het bad	the bath tub
het balkon	the balcony
het bezoek	the visit
het blad	the a) journal, magazine b) leaf
het bloed	the blood
het bos	the forest
het café	the cafe, pub
het centrum	the centre
het deel	the part
het ding	the thing
het droomhuis	the dream house
het familieverhaal	the family story
het festival	the festival
het fruit	the fruit
het gebruik	the use
het gemeentehuis	the town hall
het gereedschap	the tools
het geslacht	the sex, gender
het gesprek	the conversation, the interview
het gevolg	the result
het gezin	the family (1)
het heimwee	the homesick
het hoofdstuk	the chapter
het huisdier	the pet
het huurcontract	the rental contract
het innerlijk	the character (2)
het instrument	the tool, the (musical) instrument
het karakter	the character
het kwartiertje	the quarter of an hour
het legitimatiebewijs	the id
het leven	the life
het magazijn	the warehouse
het meer	the lake
het nachtkastje	the bedside table
het ondergoed	the underwear
het onderzoek	the check-up
het opzicht	the regard
het paasei	the Easter egg
het paspoort	the passport
het plakje	the slice
het platteland	the countryside
het plein	the square (place)
het raam	the window
het restaurant	the restaurant
het rundergehakt	the ground beef
het sap	the juice
het schaap	the sheep
het schilderij	the painting
het slachtoffer	the victim
het spreekuur	the consultation hours
het station	the railway station
het stuk	the piece
het succes	the success
het toerisme	the tourism
het toiletpapier	the toilet paper
het vakantiegeld	the vacation bonus
het varken	the pig
het verband	the a) link b) bandage
het verkeer	the traffic
het vest	the cardigan
het vriendinnetje	the girlfriend
Hoe lang?	How long? (about length)
hoeveel	how much
huidig	current
hun	them, their
iedereen	everybody
Ik weet hoe je het Nederlandse alfabet moet opzeggen	I know how to say the Dutch alphabet out loud
immigreren	to immigrate
in	in
ineens	suddenly
jammer	unfortunate, sad, too bad (adj.)
jarig zijn	to have a birthday
jij	you (singular, informal)
kamperen	camping
kloppen	to knock, to beat
knippen	to cut (with scissors)
kwaad	furious
laatst	last / final / latest
laten zien	to show
later	later (2)
leeg	empty
leerzaam	educational
leiden	to lead
lekker	nice, delicious
leren kennen	to get to know, to meet
leveren	to supply
liever ... dan ...	rather ... than ...
lijden	to suffer
los	loose (adj.)
lukken	to succeed (2)
maandag	Monday
maar	only (+countable)
mee	with, along (adv.)
menen	to believe, to think
mengen	to blend, to mix
meteen	immediately
mis	wrong (3)
misschien	perhaps
mooi	handsome / beautiful / nice / good
na	after
naar	to
naast	next to
nadat	after (2)
nauwelijks	hardly
net	just (a moment ago, только что)
nieuwsgierig	curious
noemen	to name, to call smth
normaal	normal, usual
officieel	official
omdraaien	to turn (2)
ondanks	despite
ondergronds	underground
onderzoeken	to investigate
onduidelijk	unclear
ongeveer	about (2)
ontslaan	to fire
ontspannen	relaxed
ontvangen	to receive
ontwikkelen	to develop
ooit	ever
ook	as well / too / also
openstaand	open, available (adj.)
opnieuw	again (1)
opschrijven	write down
opstellen	to draw up
optreden	to appear (2)
opvallen	to strike, to catch the eye
opzetten	to set up
opzoeken	to look up
ouderwets	old-fashioned
Oudjaar	New year’s eve
overal	everywhere
overig	other (2)
overlijden	to die
overtuigen	to convince
overwegen	to consider
parkeren	to park
pas	only/just (a small while ago)
passend	suitable
perfect	perfect
plaatsen	to place (2)
plat	flat
poetsen	to polish, clean
prachtig	wonderful (2)
prima	wonderful
raken	to touch, to hit
realiseren	to realize
redelijk	quite
reeds	already (formal)
regelen	to regulate, to arrange
romantisch	romantic
ruim	spacious
rustig	calm(ly)
schillen	to peel
schoonmaken	to clean
serveren	to serve
slaan	to hit
slagen	to succeed (1)
slecht	bad
snel	soon
sporten	to excersise sport
springen	to jump
steken	a) to stab b) to put (6, in general, used in Be)
stellen	to put (5, currently used very rare)
sterven	to expire
stevig	firm, solid
stil	quiet
stoppen	to put smth in pocket, wallet (4)
straks	later
strijken	to iron
tegenwoordig	nowadays
tenslotte	at last
tevreden	satisfied
toe	towards
toen	then (about the past)
toevallig	accidental
tot morgen	see you tomorrow
tot snel	see you soon
trouwens	moreover, besides, by the way
Turkije	Turkey
tweedehands	second-hand
twintigste	twentieth
uit	from (1)
uitdoen	to turn off
uiteindelijk	final (adj.)
uiteraard	of course, naturally (2)
uittrekken	to take off smth with (un)pulling motion (pants, socks)
vanwege	because of
verdelen	to divide
verdwijnen	to disappear
vergissen	to be mistaken
verhitten	to heat
verkeerd	wrong, incorrect
verklaren	to explain (2)
verlegen	shy
verliefd worden	to fall in love
verliezen	to lose
verloofd	engaged
vers	fresh
verschijnen	to appear
verschrikkelijk	terrible
vertrekken	to leave (expected to be back)
vervelend	annoying
vervolgens	afterwards (2)
vijf voor half zeven	twenty five past six
voeren	to carry out
voldoende	sufficient
volgens	according to
volleyballen	to play volleyball
voor wie	for whom
vooral	especially
voorbereiden	to prepare
voorbij	past
vroeg	early
waaien	to blow
waard	worth
wandelen	to go for a walk
wel	good, well
werken	to work
wijzen	to point
wild	wild
wintervakantie	winter holidays
wonen	to live
zelfde	same
zich bevinden	to be located
zich legitimeren	to identify oneself
zich richten	to focus
zich schamen	to be ashamed
zielig	pathetic
zij	they
zo snel mogelijk	as soon as possible
zoals	as
zo'n	such a
zout	salty
zowel ... als ...	both ... and ...
zulk	such (3)
zwaaien	to wave
zwak	weak
