Combien ça coûte ?	How much does it cost?
Vous avez des toilettes ?	Do you have a restroom?
aujourd'hui	today
bientôt	soon
c'est trop cher	it's too expensive
cinq	five
demain	tomorrow
deux	two
deuxième	second
dimanche	Sunday
dix	ten
en espèces	in cash
fermé	closed
hier	yesterday
huit	eight
je cherche	I am looking for ...
je voudrais	I would like ...
jeudi	Thursday
la boulangerie	the bakery
la caisse	the checkout
la gare	the train station
la ligne	the metro/bus line
la nuit	the night
la rue	the street
la sortie	the exit
la station de métro	the metro station
la ville	the city
le billet	the ticket
le bus	the bus
le centre-ville	the city center
le feu rouge	the traffic light
le magasin	the shop
le matin	the morning
le métro	the metro
le passage piéton	the crosswalk
le plan	the map
le prix	the price
le quartier	the neighborhood
le reçu	the receipt
le soir	the evening
le supermarché	the supermarket
le taxi	the taxi
le train	the train
lundi	Monday
maintenant	now
mardi	Tuesday
mercredi	Wednesday
midi	noon
minuit	midnight
neuf	nine
ouvert	open
premier	first (m)
première	first (f)
quatre	four
samedi	Saturday
sept	seven
six	six
tard	late
trois	three
troisième	third
tôt	early
un	one
un après-midi	an afternoon
un arrêt de bus	a bus stop
un kilo de	a kilo of
un morceau de	a piece of
un paquet de	a pack of
un sac	a bag
un ticket	a ticket
une adresse	an address
une bouteille de	a bottle of
une carte bancaire	a credit card
une heure	an hour
une réduction	a discount
vendredi	Friday
